You awake, cold and wet. Your clothes are soaked, and the only source of heat is the fire that you are huddled by. In the distance, you hear a horde of robots, and you realize they are coming to get you.

The Village
An Interactive Fiction by kgoodrowe20
Release 1 / Serial number 190411 / Inform 7 build 6M62 (I6/v6.33 lib 6/12N) SD

Hut
A hut that you found yourself awake in. Shelves line the wooden walls, cluttered with various tools and junk. There is a large steel door to the east, and another exit to the west. By the steel door there is a terminal with a red/blue/green color scheme.

>628
The terminal says: INCORRECT PASSWORD, PLEASE TRY AGAIN.

>x wires
There are three wires: red, green, and blue.

>x red wire
The red wire has the number 6 printed on it.

>x green wire
The green wire has the number 2 printed on it.

>x blue wire
The blue wire has the number 8 printed on it.

>286
The terminal says: INCORRECT PASSWORD, PLEASE TRY AGAIN.

>682
The terminal says: CORRECT PASSWORD, UNLOCKING DOOR.
The door clicks.

>e
(first opening steel door)

Walkway
The walkway is a pathway outside. The snow is billowing and piling up in large amounts. There is a mountain to the north, with a fence blocking your way. To the east you see the faint glow of a distant village.

>e
Village
The village is nearly abandoned, with empty houses and damaged buildings. The walkway is to the west, and you can see a church to the east.

You can see Boltz here.

Boltz heads to Walkway.

>w
Walkway
The walkway is a pathway outside. The snow is billowing and piling up in large amounts. There is a mountain to the north, with a fence blocking your way. To the east you see the faint glow of a distant village.

You can see Boltz here.

Boltz heads to Corn field.

>s
Corn field
You can see Boltz here.

Boltz heads to Meadow.

>s
Meadow
You can see Boltz here.

Boltz heads to Corn field.

>s
You can't go that way.

>n
Corn field
Boltz arrives from Walkway. He greets you with the integrated monitor on his chest.

>n
Walkway
The walkway is a pathway outside. The snow is billowing and piling up in large amounts. There is a mountain to the north, with a fence blocking your way. To the east you see the faint glow of a distant village.

Boltz arrives from Corn field. He greets you with the integrated monitor on his chest.

>e
Village
The village is nearly abandoned, with empty houses and damaged buildings. The walkway is to the west, and you can see a church to the east.

>e
Church

>e
You can't go that way.

>w
Village
The village is nearly abandoned, with empty houses and damaged buildings. The walkway is to the west, and you can see a church to the east.

>w
Walkway
The walkway is a pathway outside. The snow is billowing and piling up in large amounts. There is a mountain to the north, with a fence blocking your way. To the east you see the faint glow of a distant village.

>n
You can't go that way.

>e
Village
The village is nearly abandoned, with empty houses and damaged buildings. The walkway is to the west, and you can see a church to the east.

* * *

You awake, cold and wet. Your clothes are soaked, and the only source of heat is the fire that you are huddled by. In the distance, you hear a horde of robots, and you realize they are coming to get you.

The Village
An Interactive Fiction by kgoodrowe20
Release 1 / Serial number 190411 / Inform 7 build 6M62 (I6/v6.33 lib 6/12N) SD

Hut
A hut that you found yourself awake in. Shelves line the wooden walls, cluttered with various tools and junk. There is a large steel door to the east, and another exit to the west. By the steel door there is a terminal with a red/blue/green color scheme.

>682
The terminal says: CORRECT PASSWORD, UNLOCKING DOOR.
The door clicks.
You hear the roar of the horde to the distant west.

you hear the horde nearby

>e
(first opening steel door)

Walkway
The walkway is a pathway outside. The snow is billowing and piling up in large amounts. There is a mountain to the north, with a fence blocking your way. To the east you see the faint glow of a distant village.

>692
That's not a verb I recognise.

* * *

>e
(first opening steel door)

Walkway
The walkway is a pathway outside. The snow is billowing and piling up in large amounts. There is a mountain to the north, with a fence blocking your way. To the east you see the faint glow of a distant village.

>e
Village
The village is nearly abandoned, with empty houses and damaged buildings. The walkway is to the west, and you can see a church to the east.

You can see Boltz here.

>take axe
Taken.

>w
Walkway
The walkway is a pathway outside. The snow is billowing and piling up in large amounts. There is a mountain to the north, with a fence blocking your way. To the east you see the faint glow of a distant village.

>cut fence
You cut down the fence, gaining access to the mountain. You see a glowing screw in the rubble and take it.

>i
You are carrying:
  glowing screw
  axe

>n
Mountain

>s
Walkway
 The walkway is a pathway outside. The snow is billowing and piling up in large amounts. There is a mountain to the north. To the east you see the faint glow of a distant village.

* * *

>n
You can't go that way.

>cut fence
You cut down the fence, gaining access to the mountain.

>n
Mountain

* * *

>e
Village
The village is nearly abandoned, with empty houses and damaged buildings. The walkway is to the west, and you can see a church to the east.

You can see Boltz here.

>x houses
Broken down houses line the edge of the village. Behind one of them, you spot an axe.

>take axe
Taken.

* * *

>e
(first opening steel door)

Walkway
The walkway is a pathway outside. The snow is billowing and piling up in large amounts. There is a mountain to the north, with a fence blocking your way. To the east you see the faint glow of a distant village.

>w
Hut
A hut that you found yourself awake in. Shelves line the wooden walls, cluttered with various tools and junk. There is a large steel door to the east, and another exit to the west. By the steel door there is a terminal with a red/blue/green color scheme.

>w
Yard
A run down yard, complete with a snowed-out garden.

>n
Please give one of the answers above.

Would you like to RESTART, RESTORE a saved game, QUIT or UNDO the last command?

>restart
You awake, cold and wet. Your clothes are soaked, and the only source of heat is the fire that you are huddled by. In the distance, you hear a horde of robots, and you realize they are coming to get you.

The Village
An Interactive Fiction by kgoodrowe20
Release 1 / Serial number 190411 / Inform 7 build 6M62 (I6/v6.33 lib 6/12N) SD

Hut
A hut that you found yourself awake in. Shelves line the wooden walls, cluttered with various tools and junk. There is a large steel door to the east, and another exit to the west. By the steel door there is a terminal with a red/blue/green color scheme.

>e
(first opening steel door)
It seems to be locked.

>682
The terminal says: CORRECT PASSWORD, UNLOCKING DOOR.
The door clicks.
You hear the roar of the horde to the distant west.

You hear the horde nearby to the north.

>n
You can't go that way.

>n
You can't go that way.

>e
(first opening steel door)

Walkway
The walkway is a pathway outside. The snow is billowing and piling up in large amounts. There is a mountain to the north, with a fence blocking your way. To the east you see the faint glow of a distant village.

You hear the horde nearby to the north.

>n
You can't go that way.

* * *

>w
Yard
A run down yard, complete with a snowed-out garden.

>s
You can't go that way.

>w
Wasteland
An empty, dead looking field.

>e
Yard
A run down yard, complete with a snowed-out garden.

>w
Wasteland
An empty, dead looking field.

>s
Barrens
Somehow, this field is even deader than the wasteland.

You can see Boltz here.

Boltz heads to Lake.

>e
Lake
A lake that appears to have frozen over solid.

You can see Boltz here.

Boltz heads to Corn field.

>e
Corn field
You can see Boltz here.

Boltz heads to Meadow. 

    *** The horde rushes you, and you get attacked. ***

Would you like to RESTART, RESTORE a saved game, QUIT or UNDO the last command?

* * *

>682
The terminal says: CORRECT PASSWORD, UNLOCKING DOOR.
The door clicks.
You hear the roar of the horde to the distant west.

you hear the horde nearby

>r
Please give one of the answers above.

Would you like to RESTART, RESTORE a saved game, QUIT or UNDO the last command?

>restart
You awake, cold and wet. Your clothes are soaked, and the only source of heat is the fire that you are huddled by. In the distance, you hear a horde of robots, and you realize they are coming to get you.

The Village
An Interactive Fiction by kgoodrowe20
Release 1 / Serial number 190409 / Inform 7 build 6M62 (I6/v6.33 lib 6/12N) SD

Hut
A hut that you found yourself awake in. Shelves line the wooden walls, cluttered with various tools and junk. There is a large steel door to the east, and another exit to the west. By the steel door there is a terminal with a red/blue/green color scheme.

>682
The terminal says: CORRECT PASSWORD, UNLOCKING DOOR.
The door clicks.
You hear the roar of the horde to the distant west.

    *** The horde rushes you, and you get attacked. ***

Would you like to RESTART, RESTORE a saved game, QUIT or UNDO the last command?

* * *

>682
The terminal says: CORRECT PASSWORD, UNLOCKING DOOR.
The door clicks.
You hear the roar of the horde to the distant west.

you hear the horde nearby

>w
Yard
A run down yard, complete with a snowed-out garden.

You can see a horde here.

    *** The horde rushes you, and you get attacked. ***

Would you like to RESTART, RESTORE a saved game, QUIT or UNDO the last command?

>r
Please give one of the answers above.

Would you like to RESTART, RESTORE a saved game, QUIT or UNDO the last command?

* * *

>w
Yard
A run down yard, complete with a snowed-out garden.

You can see a horde here.

    *** The horde rushes you, and you get attacked. ***

Would you like to RESTART, RESTORE a saved game, QUIT or UNDO the last command?

>restart
You awake, cold and wet. Your clothes are soaked, and the only source of heat is the fire that you are huddled by. In the distance, you hear a horde of robots, and you realize they are coming to get you.

The Village
An Interactive Fiction by kgoodrowe20
Release 1 / Serial number 190411 / Inform 7 build 6M62 (I6/v6.33 lib 6/12N) SD

Hut
A hut that you found yourself awake in. Shelves line the wooden walls, cluttered with various tools and junk. There is a large steel door to the east, and another exit to the west. By the steel door there is a terminal with a red/blue/green color scheme.

* * *

You awake, cold and wet. Your clothes are soaked, and the only source of heat is the fire that you are huddled by. In the distance, you hear a horde of robots, and you realize they are coming to get you.

The Village
An Interactive Fiction by kgoodrowe20
Release 1 / Serial number 190411 / Inform 7 build 6M62 (I6/v6.33 lib 6/12N) SD

Hut
A hut that you found yourself awake in. Shelves line the wooden walls, cluttered with various tools and junk. There is a large steel door to the east, and another exit to the west. By the steel door there is a terminal with a red/blue/green color scheme.

>cut
(steel door)
Cutting it up would achieve little.

>682
The terminal says: CORRECT PASSWORD, UNLOCKING DOOR.
The door clicks.

* * *

>cut
(steel door)
Cutting it up would achieve little.

>cut fence
You can't see any such thing.

* * *

You awake, cold and wet. Your clothes are soaked, and the only source of heat is the fire that you are huddled by. In the distance, you hear a horde of robots, and you realize they are coming to get you.

The Village
An Interactive Fiction by kgoodrowe20
Release 1 / Serial number 190411 / Inform 7 build 6M62 (I6/v6.33 lib 6/12N) SD

Hut
A hut that you found yourself awake in. Shelves line the wooden walls, cluttered with various tools and junk. There is a large steel door to the east, and another exit to the west. By the steel door there is a terminal with a red/blue/green color scheme.

>cut red wire
    *** You get zapped by the exposed wire and black out. ***

Would you like to RESTART, RESTORE a saved game, QUIT or UNDO the last command?

>restart
You awake, cold and wet. Your clothes are soaked, and the only source of heat is the fire that you and your dog are huddled by.

The Village
An Interactive Fiction by kgoodrowe20
Release 1 / Serial number 190314 / Inform 7 build 6M62 (I6/v6.33 lib 6/12N) SD

Hut
A hut that you found yourself awake in. Shelves line the wooden walls, cluttered with various tools and junk. There is an exit to the east, and to the west.

>put on gloves
(first taking gloves)
You put on gloves.

>cut red wire
Nothing happened.

* * *

You awake, cold and wet. Your clothes are soaked, and the only source of heat is the fire that you are huddled by. In the distance, you hear a horde of robots, and you realize they are coming to get you.

The Village
An Interactive Fiction by kgoodrowe20
Release 1 / Serial number 190411 / Inform 7 build 6M62 (I6/v6.33 lib 6/12N) SD

Hut
A hut that you found yourself awake in. Shelves line the wooden walls, cluttered with various tools and junk. There is a large steel door to the east, and another exit to the west. By the steel door there is a terminal with a red/blue/green color scheme.

>cut wires
You don't know how to work electronics; it's not safe to mess with live wire. Perhaps find something to help you?

* * *

You awake, cold and wet. Your clothes are soaked, and the only source of heat is the fire that you are huddled by. In the distance, you hear a horde of robots, and you realize they are coming to get you.

The Village
An Interactive Fiction by kgoodrowe20
Release 1 / Serial number 190411 / Inform 7 build 6M62 (I6/v6.33 lib 6/12N) SD

Hut
A hut that you found yourself awake in. Shelves line the wooden walls, cluttered with various tools and junk. There is a large steel door to the east, and another exit to the west. By the steel door there is a terminal with a red/blue/green color scheme.

>e
(first opening steel door)
It seems to be locked.

>682
The terminal says: CORRECT PASSWORD, UNLOCKING DOOR.
The door clicks.

>e
(first opening steel door)

Walkway
The walkway is a pathway outside. The snow is billowing and piling up in large amounts. There is a mountain to the north, with a fence blocking your way.

>e
Village
You can see boltz and axe here.

* * *

>e
(first opening steel door)
It seems to be locked.

>e
(first opening steel door)
It seems to be locked.

>n
Mountain

>n
Summit

* * *

>e
(first opening steel door)
It seems to be locked.

>x dooe
You can't see any such thing.

>x door
A large, industrial steel door.

>x terminal
The terminal says: YOU ARE BEING RECORDED. PLEASE SAY THE PASSWORD INTO THE TERMINAL.

>682
The terminal says: CORRECT PASSWORD, UNLOCKING DOOR.
The door clicks.

* * *

>e
(first opening steel door)

Walkway
The walkway is a pathway outside. The snow is billowing and piling up in large amounts. There is a mountain to the north, with a fence blocking your way. To the east you see the faint glow of a distant village.

>n
You can't go that way.

>e
Village
The village is nearly abandoned, with empty houses and damaged buildings. The walkway is to the west, and you can see a church to the east.

You can see Boltz here.

>talk to boltz
That's not a verb I recognise.

* * *

>e
(first opening steel door)
It seems to be locked.

>x door
You see nothing special about steel door.

>x shelves
Hammers, nails, and other tools are scattered all over the shelves. There's a shovel behind the shelves. Next to the shelves, you can see an open metal box attached to the wall. There are wires inside.

>x metal box
There are three wires: red, blue, and green.

>cut red wire
    *** You get zapped by the exposed wire and black out. Look for something to protect yourself from the electricity. ***

Would you like to RESTART, RESTORE a saved game, QUIT or UNDO the last command?

>undo
Hut
[Previous turn undone.]

>cut blue wire
    *** You get zapped by the exposed wire and faint. Look for something to protect yourself from the electricity. ***

Would you like to RESTART, RESTORE a saved game, QUIT or UNDO the last command?

>undo
Hut
[Previous turn undone.]

>cut green wire
    *** You get zapped by the exposed wire and black out. A key fell out of the wall though. Look for something to protect yourself from the electricity. ***

Would you like to RESTART, RESTORE a saved game, QUIT or UNDO the last command?

* * *

>e
(first opening steel door)

Walkway
The walkway is a pathway outside. The snow is billowing and piling up in large amounts. There is a mountain to the north, with a fence blocking your way.

>w
Hut
A hut that you found yourself awake in. Shelves line the wooden walls, cluttered with various tools and junk. There is a large steel door to the east, and another exit to the west. By the steel door there is a keypad with a red/blue/green color scheme.

* * *

You awake, cold and wet. Your clothes are soaked, and the only source of heat is the fire that you are huddled by. In the distance, you hear a horde of robots, and you realize they are coming to get you.

The Village
An Interactive Fiction by kgoodrowe20
Release 1 / Serial number 190411 / Inform 7 build 6M62 (I6/v6.33 lib 6/12N) SD

Hut
A hut that you found yourself awake in. Shelves line the wooden walls, cluttered with various tools and junk. There is a large steel door to the east, and another exit to the west. By the steel door there is a terminal with a red/blue/green color scheme.

>follow
That's not a verb I recognise.

>follow
That's not a verb I recognise.

* * *

You awake, cold and wet. Your clothes are soaked, and the only source of heat is the fire that you are huddled by. In the distance, you hear a horde of robots, and you realize they are coming to get you.

The Village
An Interactive Fiction by kgoodrowe20
Release 1 / Serial number 190411 / Inform 7 build 6M62 (I6/v6.33 lib 6/12N) SD

Hut
A hut that you found yourself awake in. Shelves line the wooden walls, cluttered with various tools and junk. There is a large steel door to the east, and another exit to the west. By the steel door there is a terminal with a red/blue/green color scheme.

>put on gloves
(first taking gloves)
You put on gloves.

>cut red wire
Nothing happened.

    *** The End ***

Would you like to RESTART, RESTORE a saved game, QUIT or UNDO the last command?

* * *

You awake, cold and wet. Your clothes are soaked, and the only source of heat is the fire that you are huddled by. In the distance, you hear a horde of robots, and you realize they are coming to get you.

The Village
An Interactive Fiction by kgoodrowe20
Release 1 / Serial number 190411 / Inform 7 build 6M62 (I6/v6.33 lib 6/12N) SD

Hut
A hut that you found yourself awake in. Shelves line the wooden walls, cluttered with various tools and junk. There is a large steel door to the east, and another exit to the west. By the steel door there is a terminal with a red/blue/green color scheme.

>put on glovs
You can't see any such thing.

>put on gloves
(first taking gloves)
You put on gloves.

>cut green wire
You cut the green wire and a part of the wall slides out to expose a key that can be used on the steel door.

>l
Hut
A hut that you found yourself awake in. Shelves line the wooden walls, cluttered with various tools and junk. There is a large steel door to the east, and another exit to the west.

You can see key here.

>take key
Taken.

>unlock steel door with key
You unlock steel door.

>e
(first opening steel door)

walkway
The walkway is a pathway outside. The snow is billowing and piling up in large amounts. There is a mountain to the north, with a fence blocking your way.

* * *

You awake, cold and wet. Your clothes are soaked, and the only source of heat is the fire that you are huddled by. In the distance, you hear a horde of robots, and you realize they are coming to get you.

The Village
An Interactive Fiction by kgoodrowe20
Release 1 / Serial number 190411 / Inform 7 build 6M62 (I6/v6.33 lib 6/12N) SD

Hut
A hut that you found yourself awake in. Shelves line the wooden walls, cluttered with various tools and junk. There is a large steel door to the east, and another exit to the west. By the steel door there is a terminal with a red/blue/green color scheme.

>s
You can't go that way.

>682
The terminal says: CORRECT PASSWORD, UNLOCKING DOOR.
The door clicks.

>e
(first opening steel door)

Walkway
The walkway is a pathway outside. The snow is billowing and piling up in large amounts. There is a mountain to the north, with a fence blocking your way. To the east you see the faint glow of a distant village.

Boltz arrives from Village.

>hi
That's not a verb I recognise.

>ask about man
You can't see any such thing.

>ask about mountain
You can't see any such thing.

* * *

You awake, cold and wet. Your clothes are soaked, and the only source of heat is the fire that you are huddled by. In the distance, you hear a horde of robots, and you realize they are coming to get you.

The Village
An Interactive Fiction by kgoodrowe20
Release 1 / Serial number 190411 / Inform 7 build 6M62 (I6/v6.33 lib 6/12N) SD

Hut
A hut that you found yourself awake in. Shelves line the wooden walls, cluttered with various tools and junk. There is a large steel door to the east, and another exit to the west. By the steel door there is a terminal with a red/blue/green color scheme.

>take gloves
Taken.

>put on gloves
You put on Gloves.

* * *

You awake, cold and wet. Your clothes are soaked, and the only source of heat is the fire that you are huddled by. In the distance, you hear a horde of robots, and you realize they are coming to get you.

The Village
An Interactive Fiction by kgoodrowe20
Release 1 / Serial number 190411 / Inform 7 build 6M62 (I6/v6.33 lib 6/12N) SD

Hut
A hut that you found yourself awake in. Shelves line the wooden walls, cluttered with various tools and junk. There is a large steel door to the east, and another exit to the west. By the steel door there is a terminal with a red/blue/green color scheme.

>take keypad
Taken.

>drop keypad
Dropped.

* * *

You awake, cold and wet. Your clothes are soaked, and the only source of heat is the fire that you are huddled by. In the distance, you hear a horde of robots, and you realize they are coming to get you.

The Village
An Interactive Fiction by kgoodrowe20
Release 1 / Serial number 190411 / Inform 7 build 6M62 (I6/v6.33 lib 6/12N) SD

Hut
A hut that you found yourself awake in. Shelves line the wooden walls, cluttered with various tools and junk. There is a large steel door to the east, and another exit to the west. By the steel door there is a terminal with a red/blue/green color scheme.

>take toolbox
Taken.

>drop toolbox
Dropped.

>x toolbox
In toolbox is Wire cutters.

* * *

You awake, cold and wet. Your clothes are soaked, and the only source of heat is the fire that you are huddled by. In the distance, you hear a horde of robots, and you realize they are coming to get you.

The Village
An Interactive Fiction by kgoodrowe20
Release 1 / Serial number 190411 / Inform 7 build 6M62 (I6/v6.33 lib 6/12N) SD

Hut
A hut that you found yourself awake in. Shelves line the wooden walls, cluttered with various tools and junk. There is a large steel door to the east, and another exit to the west. By the steel door there is a terminal with a red/blue/green color scheme.

>talk to boltz
That's not a verb I recognise.

* * *

You awake, cold and wet. Your clothes are soaked, and the only source of heat is the fire that you are huddled by. In the distance, you hear a horde of robots, and you realize they are coming to get you.

The Village
An Interactive Fiction by kgoodrowe20
Release 1 / Serial number 190411 / Inform 7 build 6M62 (I6/v6.33 lib 6/12N) SD

Hut
A hut that you found yourself awake in. Shelves line the wooden walls, cluttered with various tools and junk. There is a large steel door to the east, and another exit to the west. By the steel door there is a terminal with a red/blue/green color scheme.

>w
Yard
You can see dog here.

>e
Hut
A hut that you found yourself awake in. Shelves line the wooden walls, cluttered with various tools and junk. There is an exit to the east, and to the west.

>e
Walkway
The walkway is a pathway outside. The snow is billowing and piling up in large amounts. There is a mountain to the north, with a fence blocking your way.

>n
Mountain

* * *

>w
Yard
You can see dog here.

>talk to dog
That's not a verb I recognise.

>hi
That's not a verb I recognise.

>dig
That's not a verb I recognise.

>e
Hut
A hut that you found yourself awake in. Shelves line the wooden walls, cluttered with various tools and junk. There is a large steel door to the east, and another exit to the west. By the steel door there is a terminal with a red/blue/green color scheme.

>e
(first opening steel door)
It seems to be locked.

>682
CORRECT PASSWORD, UNLOCKING DOOR. The door clicks.

* * *

You awake, cold and wet. Your clothes are soaked, and the only source of heat is the fire that you are huddled by. In the distance, you hear a horde of robots, and you realize they are coming to get you.

The Village
An Interactive Fiction by kgoodrowe20
Release 1 / Serial number 190411 / Inform 7 build 6M62 (I6/v6.33 lib 6/12N) SD

Hut
A hut that you found yourself awake in. Shelves line the wooden walls, cluttered with various tools and junk. There is a large steel door to the east, and another exit to the west. By the steel door there is a terminal with a red/blue/green color scheme.

>x door
A large, industrial steel door.

>e
(first opening steel door)
It seems to be locked.

>s
You can't go that way.

>a
That's not a verb I recognise.

* * *

You awake, cold and wet. Your clothes are soaked, and the only source of heat is the fire that you are huddled by. In the distance, you hear a horde of robots, and you realize they are coming to get you.

The Village
An Interactive Fiction by kgoodrowe20
Release 1 / Serial number 190411 / Inform 7 build 6M62 (I6/v6.33 lib 6/12N) SD

Hut
A hut that you found yourself awake in. Shelves line the wooden walls, cluttered with various tools and junk. There is a large steel door to the east, and another exit to the west. By the steel door there is a terminal with a red/blue/green color scheme.

>x metal box
There are three wires: red, blue, and green.

>cut
What do you want to cut?

* * *

You awake, cold and wet. Your clothes are soaked, and the only source of heat is the fire that you are huddled by. In the distance, you hear a horde of robots, and you realize they are coming to get you.

The Village
An Interactive Fiction by kgoodrowe20
Release 1 / Serial number 190411 / Inform 7 build 6M62 (I6/v6.33 lib 6/12N) SD

Hut
A hut that you found yourself awake in. Shelves line the wooden walls, cluttered with various tools and junk. There is a large steel door to the east, and another exit to the west. By the steel door there is a terminal with a red/blue/green color scheme.

>x red wire
You see nothing special about red wire.

* * *

You awake, cold and wet. Your clothes are soaked, and the only source of heat is the fire that you are huddled by. In the distance, you hear a horde of robots, and you realize they are coming to get you.

The Village
An Interactive Fiction by kgoodrowe20
Release 1 / Serial number 190411 / Inform 7 build 6M62 (I6/v6.33 lib 6/12N) SD

Hut
A hut that you found yourself awake in. Shelves line the wooden walls, cluttered with various tools and junk. There is a large steel door to the east, and another exit to the west. By the steel door there is a terminal with a red/blue/green color scheme.

>x shelves
Hammers, nails, wire cutters, and other tools are scattered all over the shelves. There is a bright red toolbox sitting on one of the shelves. There's a shovel behind the shelves. Next to the shelves, you can see an open metal box attached to the wall. There are wires inside.

>x wire cutter
A rusted pair of wire cutters. The blade still seems sharp though.

>x toolbox
Toolbox is empty.

* * *

You awake, cold and wet. Your clothes are soaked, and the only source of heat is the fire that you are huddled by. In the distance, you hear a horde of robots, and you realize they are coming to get you.

The Village
An Interactive Fiction by kgoodrowe20
Release 1 / Serial number 190411 / Inform 7 build 6M62 (I6/v6.33 lib 6/12N) SD

Hut
A hut that you found yourself awake in. Shelves line the wooden walls, cluttered with various tools and junk. There is a large steel door to the east, and another exit to the west. By the steel door there is a terminal with a red/blue/green color scheme.

>x shovel
An old, rusty shovel.

* * *

You awake, cold and wet. Your clothes are soaked, and the only source of heat is the fire that you are huddled by. In the distance, you hear a horde of robots, and you realize they are coming to get you.

The Village
An Interactive Fiction by kgoodrowe20
Release 1 / Serial number 190411 / Inform 7 build 6M62 (I6/v6.33 lib 6/12N) SD

Hut
A hut that you found yourself awake in. Shelves line the wooden walls, cluttered with various tools and junk. There is a large steel door to the east, and another exit to the west. By the steel door there is a terminal with a red/blue/green color scheme.

>x terminal
The terminal says: YOU ARE BEING RECORDED. PLEASE SAY THE PASSWORD INTO THE TERMINAL.

>682
The terminal says: CORRECT PASSWORD, UNLOCKING DOOR.
The door clicks.
You hear the roar of the horde to the distant west.

>w
Yard
You can see a horde and dog here.

The horde heads to Wasteland.

* * *

You awake, cold and wet. Your clothes are soaked, and the only source of heat is the fire that you are huddled by. In the distance, you hear a horde of robots, and you realize they are coming to get you.

The Village
An Interactive Fiction by kgoodrowe20
Release 1 / Serial number 190411 / Inform 7 build 6M62 (I6/v6.33 lib 6/12N) SD

Hut
A hut that you found yourself awake in. Shelves line the wooden walls, cluttered with various tools and junk. There is a large steel door to the east, and another exit to the west. By the steel door there is a terminal with a red/blue/green color scheme.

>x toolbox
In the toolbox are wire cutters, gloves and a manual.

I beg your pardon?

I beg your pardon?

>x toolbox
Toolbox is empty.

>x toolbox
Toolbox is empty.

>i
You are carrying nothing.

* * *

>x toolbox
In the toolbox are wire cutters, gloves and a manual.

>open toolbox
It isn't something you can open.